|=================================================================================================|
|S                                                                                                |
| =============================================================================================== |
|                                                                                                 |
| ================================================================================================|
|                                                                                                 |
| =============================================================================================== |
|                                                                                                 |
| ================================================================================================|
|                                                                                                 |
| =============================================================================================== |
|                                                                                                 |
| ================================================================================================|
|                                                                                                 |
| =============================================================================================== |
|                                                                                                 |
| ================================================================================================|
|                                                                                                 |
| =============================================================================================== |
|                                                                                                 |
| ================================================================================================|
|                                                                                                 |
| =============================================================================================== |
|G                                                                                                |
|=================================================================================================|